6
[0 0 0]
[187 239 238]
[38 123 139]
[0 25 50]
[[231 156 33] [231 156 33] [156 74 0] [82 33 0] [156 74 0]]
[156 74 0]
10
ground.txt 1
brick.txt 2 1
question.txt 3 1
question.txt 4 1
brick.txt 3 1
brick.txt 4 1
question.txt 4 1
block.txt 1
coin.txt 6 0 15
brickSmooth.txt 2
15 46
8 1 1 1 1 1 8 1 1 1 1 1 1 1 1 1 8 1 1 1 1 1 1 8 1 1 8 1 1 1 8 1 1 1 1 1 1 1 1 1 1 1 1 1 1 1
10 0 9 9 9 0 1 0 0 0 0 0 0 0 0 0 1 0 0 0 0 0 0 1 0 0 1 0 0 0 1 0 0 0 0 0 0 0 0 0 0 0 0 0 0 0
10 0 9 9 9 0 1 0 0 0 0 0 0 0 0 0 1 0 0 0 0 0 0 1 0 0 1 0 0 0 1 0 0 0 0 0 0 0 0 0 0 0 0 0 0 0
10 0 0 0 0 0 1 0 0 0 0 0 0 0 0 0 1 0 0 0 0 0 0 1 0 0 1 0 0 0 1 0 0 0 0 9 9 0 0 9 9 0 0 0 0 0
10 0 0 0 0 0 1 0 0 0 0 0 0 0 8 0 1 0 0 0 0 0 0 8 1 1 8 0 0 0 1 0 0 0 0 9 9 0 0 9 9 0 0 0 0 0
10 0 0 0 0 0 1 0 0 0 0 0 0 0 1 0 1 0 0 0 0 0 9 9 9 9 9 9 0 0 1 0 0 0 0 9 9 0 0 9 9 0 0 0 0 0
10 0 0 0 0 0 1 9 9 0 0 0 0 0 1 0 1 10 8 1 1 8 0 0 0 0 0 0 8 0 1 0 0 0 0 9 9 0 0 9 9 0 0 0 0 0
10 0 0 9 0 0 8 2 2 8 0 0 0 0 1 0 8 0 0 0 0 1 9 9 9 9 9 9 1 0 1 0 0 0 0 0 0 0 0 0 0 0 0 0 0 0
10 0 0 0 0 0 0 0 0 1 9 8 1 1 8 0 0 0 0 0 0 1 0 0 0 0 0 0 1 0 1 0 0 0 9 0 0 0 0 0 0 9 0 0 0 0
1 0 0 10 0 0 0 0 0 1 0 0 0 0 8 1 1 1 8 9 9 1 0 0 0 0 0 0 1 0 1 0 0 0 9 9 0 0 0 0 9 9 0 0 0 0
8 1 1 8 0 0 0 0 0 8 1 1 1 0 1 0 0 0 1 0 0 1 0 0 0 0 0 0 1 0 1 0 0 0 0 9 9 9 9 9 9 0 0 0 0 0
0 10 0 0 0 0 0 0 0 1 2 2 8 0 8 0 8 0 1 0 0 1 0 0 0 0 0 0 1 0 8 9 0 0 0 0 9 9 9 9 0 0 0 0 0 0
0 10 0 0 0 0 0 0 0 10 4 3 0 0 0 0 0 0 1 0 0 1 0 0 0 0 0 0 1 0 9 9 0 0 0 0 0 0 0 0 0 0 0 0 0 0
0 10 1 1 1 1 1 1 1 8 1 1 1 1 1 1 1 1 8 1 1 1 0 0 0 0 0 0 1 1 1 1 1 1 1 1 1 1 1 1 1 1 1 1 1 1
0 8 1 1 1 1 1 1 1 1 1 1 1 1 1 1 1 1 1 1 1 1 0 0 0 0 0 0 1 1 1 1 1 1 1 1 1 1 1 1 1 1 1 1 1 1
