6
[0 0 0]
[187 239 238]
[38 123 139]
[0 25 50]
[[231 156 33] [231 156 33] [156 74 0] [82 33 0] [156 74 0]]
[156 74 0]
11
ground.txt 1
brick.txt 2 1
question.txt 3 1
question.txt 4 1
brick.txt 3 1
brick.txt 4 1
question.txt 4
block.txt 1
coin.txt 6 0 15
brickSmooth.txt 2
cloud.txt 1 0 7
16 50
0 0 0 0 0 0 0 0 0 0 0 0 0 0 0 0 0 0 0 0 0 0 0 0 0 0 0 0 0 0 0 0 0 0 0 0 0 0 0 0 0 0 0 0 0 0 0 0 0 0
8 1 1 1 10 10 10 0 1 1 1 1 1 1 1 1 1 1 1 1 0 1 1 1 1 1 1 1 1 1 1 1 1 1 1 1 1 1 1 1 1 1 1 1 1 1 1 1 1 1
1 0 0 0 0 0 1 4 0 0 0 1 0 0 0 1 0 0 0 1 0 0 0 1 0 0 0 0 0 1 1 1 1 1 1 0 0 0 0 0 0 0 0 0 0 0 0 0 0 0
1 0 1 1 1 1 1 0 0 0 0 1 0 0 0 1 0 0 0 1 0 0 0 1 0 0 0 0 0 1 1 1 1 1 1 0 0 0 0 0 0 9 0 0 0 0 0 0 0 0
1 0 0 0 0 0 1 0 0 0 0 1 0 0 0 1 0 0 0 1 0 0 0 1 0 0 0 0 0 1 1 1 1 1 1 0 0 0 0 0 9 9 0 0 0 0 0 0 0 0
1 0 0 0 0 0 1 0 0 1 0 0 0 1 0 0 0 1 0 1 0 0 0 1 0 0 0 0 0 1 1 1 1 1 1 0 0 0 0 9 9 9 0 0 0 0 0 0 0 0
1 0 9 9 9 0 1 0 0 1 1 1 1 1 1 1 1 1 0 1 0 1 0 1 0 0 0 0 0 1 1 1 1 1 1 0 0 0 0 0 0 9 0 0 0 0 0 0 0 0
1 0 0 0 0 0 11 11 11 11 0 0 0 0 0 0 0 1 0 1 0 1 0 1 0 0 0 0 0 1 1 1 1 1 1 0 0 0 0 0 0 9 0 0 0 0 0 0 0 0
1 0 0 0 0 0 0 0 0 0 0 0 0 0 0 0 0 1 0 1 11 1 0 1 0 0 0 0 0 1 1 1 1 1 1 0 0 0 0 0 0 9 0 0 0 0 10 0 0 0
1 0 0 0 0 0 0 0 0 0 0 0 0 0 0 0 0 1 0 1 10 1 0 1 0 0 0 0 0 1 1 1 1 1 1 0 0 0 0 0 0 9 0 0 10 0 10 0 10 0
8 1 1 10 10 8 0 0 0 0 0 10 0 0 10 10 11 1 0 0 0 1 0 1 0 0 0 0 0 1 1 1 1 1 1 0 0 0 0 0 0 9 0 0 10 10 10 10 10 0
1 0 0 0 0 1 0 8 8 0 0 1 1 1 1 9 9 1 0 0 0 1 0 9 0 0 0 0 0 1 1 1 1 1 1 0 0 0 0 0 0 9 0 0 10 10 10 10 10 0
1 3 0 0 0 1 0 8 8 0 0 1 1 1 1 9 9 11 3 1 1 1 1 1 1 0 0 0 0 1 1 1 1 1 1 10 1 0 0 0 0 9 0 0 10 10 0 10 10 0
1 0 0 0 0 1 0 0 0 0 0 1 1 1 1 9 10 10 10 10 10 10 10 10 10 10 3 0 0 0 0 0 0 0 0 0 1 0 0 0 0 8 0 0 10 10 0 10 10 0
1 1 1 1 1 8 1 1 1 0 0 1 1 1 1 1 1 1 1 1 1 1 1 1 1 1 1 1 9 9 9 9 9 9 9 9 1 1 1 1 1 1 1 1 1 1 1 1 1 1
1 1 1 1 1 1 1 1 1 0 0 0 0 0 0 0 0 0 0 0 0 0 0 0 0 0 0 0 0 0 0 0 0 0 0 0 1 1 1 1 1 1 1 1 1 1 1 1 1 1
